0, 0, 0, 0, 0, 0, 0, 0, 0, 0, 0, 0, 0, 0, 0, 0
0, 0, 0, 0, 0, 0, 0, 0, 0, 0, 0, 0, 0, 0, 0, 0
0, 0, 0, 0, 0, 0, 0, 0, 0, 0, 0, 0, 0, 0, 0, 0
0, 0, 0, 0,16,16, 0, 0, 0, 0, 0, 0, 3, 0, 0, 0
0, 0, 0, 0,16,16, 0, 0, 0, 0, 0, 3, 3, 0, 0, 0
0, 0, 0, 0, 0, 0, 0, 0, 0, 0, 3, 3, 0, 0, 0, 0
0, 0, 0, 0, 0, 0, 0, 0, 0, 3, 3, 0, 0, 0, 0, 0
0, 0, 0, 0, 0, 0, 0, 0,11, 3, 0, 0, 0, 0, 0, 0
0, 0, 0, 0, 0, 0, 0,11,11, 0, 0, 0, 0, 0, 0, 0
0, 0, 0, 0, 0, 0, 3,11, 0, 0, 0, 0, 0, 0, 0, 0
0, 0, 0, 0, 0, 3, 3, 0, 0, 0, 0, 0, 0, 0, 0, 0
0, 0, 0, 0, 3, 3, 0, 0, 0, 0, 0, 0, 0, 0, 0, 0
0, 0, 0, 3, 3, 0, 0, 0, 0, 0, 0,16,16, 0, 0, 0
0, 0, 0, 3, 0, 0, 0, 0, 0, 0, 0,16,16, 0, 0, 0
0, 0, 0, 0, 0, 0, 0, 0, 0, 0, 0, 0, 0, 0, 0, 0
0, 0, 0, 0, 0, 0, 0, 0, 0, 0, 0, 0, 0, 0, 0, 0
0, 0, 0, 0, 0, 0, 0, 0, 0, 0, 0, 0, 0, 0, 0, 0
