0, 0, 0, 0, 0, 0, 0, 0, 0, 0, 0, 0, 0, 0, 0, 0
0, 0, 0, 0, 0, 0, 0, 0, 0, 0, 0, 0, 0, 0, 0, 0
0, 0, 0, 0, 0, 0, 0, 0, 0, 0, 0, 0, 0, 0, 0, 0
0, 0,10, 0, 0, 0,10, 2, 2,10, 0, 0, 0,10, 0, 0
0, 0,10, 0, 0, 0, 0, 0, 0, 0, 0, 0, 0,10, 0, 0
0, 0,10,10, 0, 0, 0, 0, 0, 0, 0, 0,10,10, 0, 0
0, 0, 0,10, 0, 0, 0, 0, 0, 0, 0, 0,10, 0, 0, 0
0, 0, 0, 2, 0, 0, 0, 0, 0, 0, 0, 0, 2, 0, 0, 0
0, 0, 0, 2, 0, 0, 0, 0, 0, 0, 0, 0, 2, 0, 0, 0
0, 0, 0, 2, 0, 0, 0, 0, 0, 0, 0, 0, 2, 0, 0, 0
0, 0, 0,10, 0, 0, 0, 0, 0, 0, 0, 0,10, 0, 0, 0
0, 0,10,10, 0, 0, 0, 0, 0, 0, 0, 0,10,10, 0, 0
0, 0,10, 0, 0, 0, 0, 0, 0, 0, 0, 0, 0,10, 0, 0
0, 0,10, 0, 0, 0,10, 2, 2,10, 0, 0, 0,10, 0, 0
0, 0, 0, 0, 0, 0, 0, 0, 0, 0, 0, 0, 0, 0, 0, 0
0, 0, 0, 0, 0, 0, 0, 0, 0, 0, 0, 0, 0, 0, 0, 0
0, 0, 0, 0, 0, 0, 0, 0, 0, 0, 0, 0, 0, 0, 0, 0
